###################
#........#........#
#.##.###.#.###.##.#
#.##.###.#.###.##.#
#.................#
#.##.#.#####.#.##.#
#....#...#...#....#
####.###.#.###.####
####.#.......#.####
####.# ##-##.#.####
.......#   #.......
####.#.##-##.#.####
####.#.......#.####
####.# #####.#.####
#........#........#
#.##.###.#.###.##.#
#..#...........#..#
##.#.#.#####.#.#.##
#....#...#...#....#
#.######.#.######.#
#.................#
###################
