################
#..............#
#.############.#
#.#..........#.#
#.#####.######.#
#.#......#...#.#
#.#####.####.#.#
#..............#
################
