################
#              #
# ############ #
# #          # #
# ##### ###### #
# #      #   # #
# #####  ### # #
#              #
################
